1111111111
111C1C0001
100CP01001
100C00E111
1C00001011
101C0C0001
1C101100C1
1010000C11
1C10101011
1111111111
