1111111111
1011C00001
1100000P01
1101000011
10011C1001
100C000001
100C000011
1000000001
1000000011
1111111111
