111111111111111111111111
1E10C000C0E010CE00101101
1101CC00001ECE0101001001
1C01C1001CC1CCC00110C1C1
101EE00E10C1C00010010101
1C100E000110P01CCC00E111
1E101C11100C11E00C1EE0E1
10E0E0C0EE0CCE0CE10C1011
10010E00000C1100C0001001
111111111111111111111111