1111111111
111C001101
11C00001C1
1100000101
1001110001
1010010001
1000001011
1010000011
100P0000E1
1111111111
