1111111111
1A00001011
1C01111011
100PC01C01
100E110101
1001010001
1C0C010101
1001000001
1000100C01
1111111111
