1111111111111111111111111111111111111111111111111111111111111111111111111111111111111111111111111111
1010C01001000011000C10001101100C0000C00010100110C0CC1100100001101010010110C0110010000CCCC1001C001001
1CC1000001001001C0001100C1000100011C10100010000000001111C0C00101001010000100C001100000110010100000C1
100001010000000001000000010001100CC00000011000010C0C0C011010000C001C1C11C1C00C0C1CC0000100011001CC11
10000000000001C1000010111C11101010C1001101C00C1110000101101011E0000C10111100000110001011010000100011
100C01001101010011001100000C00C00C100001000111101C11010011000C0010C0110001000CC00C110110CC1000011101
1110000000100101001CCC000000C11C1011100011000000C0011010101010100100C100001C00010000001C00110C000001
11C10000110001101000C10100100110100C1C1101000010000000001001000001011000100111C01110CC10010010101001
1000100C1100000001100C10010000C0100C0000C00011001000101000000001C00100000C0000C001100111100001000001
100001000C01110100010100101100010010100C0C011000CC000CC0C000010000000100C0001C1011010C00010011C0C001
1001100C00C100100C01001C100110010C010110C0010110C1001C100C01100001010C0C00000001110001000100000CCCC1
101C00000001100001000000011000C0C01001C00001000111C00001CC10010000000011000C0001C0C0100100111C110001
101000C0C00011000C010000001010C001111C1000C11000C01C010CC1101100C00C11C11001C00C00CC0C001100100C1111
11100000111000C000011000000000000001001000000110100000011000101101110100C0CC000000110111110111C01101
1111110C101000000000001100010010CC00110001000010010C0010000000C10010110001C11C1000000010000001011001
10000C00C100000C10111C000000C000C100001C01C01101000CC000C0010110C00010101C00110100C1CC001010001C10C1
110100111C1100000C0C100001111C110C100010C0100C000000000C0000000011C010000101000100100011C01000010011
1000C001101100001100110111111CC100000000C110000C000C000C10CC010C010010111000C00000001C0100C00C000001
10C0010110000100000000000101C01CC11010100110C111111C100111001100001000010C10011000C01101C11000010001
11100000010C10001001100010C1100000C0101101001010C00000110000001CC00011100001110100000011010C01111111
1001C100000000010001000000110001100000100010000C00100100CC1000CC111110011100110100000110110111100C11
1010101011C1001101100001000C10001010110C0101000000CC00001000110001101C1011C00010C1000011010111001C01
11000000001101011C0100001110C0100C101001C101000C1100011100001C0100000000100C0C0010010100010100001001
10001000000C000100000C01000C011100110010010C01010001111000001CCC00101C00CC000110CC0100010010001CC001
1000C000010001C000000000111001100000000CC010110011100010C00001C0C00010000000000C010C1CC1010110000011
1000100101100110110001C111000C001C10100CCC10C11100001110100000001001110010C00001C0010CC1001000100111
10100110C0C011C101001100000011000C1000011C0001001C01001000011001000000010C0CC1111101CC0C00C000100111
110010000011C0C100C00001000101C1000000010001110011000000010011000100C00000CC00000100110C10011C000011
100001CC00000010010111001101000C00110101100C1001010011000000110000001000000C00C101101000100010010011
101000001010C0C100010010000C00100010000000001100001100011C0C00000010C0000000P1C0C1C0001000100C0100C1
100000100001100110C1C1110001101C000000100000C01CC0C01100100000100011CC0C0000000011C00001010010C100C1
1001101000000110100110C000000C10C1C000000101111110000C00000000011101C0010101011101C00000000110C10111
10C1C00111C001011100000111C0011100100010100C0C01010100010010010100000011110110000101010000000C000001
100C000001011101C0111C01000C01100CC1001000000100C01001100001000C0100010C00010100010010C100C100100101
1C00C10101011101110000110011000C00000000C101C1C1011000000000000010C00010000C001011C0C0C000CC11110001
1C01101C0101100C010C100000001C0000101110C0C110010100101C110010001011C0C0C100111010001100100011011001
110010000000000100100C01010000001101C1101000C1CC00010C00010000101C00100C0010C00010000000011C1C011011
110000100010001000001101000C1100C10110011010100000C11101010111C00C001001011011C010000110C10001101101
10000011000C1000C010C00001100010C00100111100011001CC1010111C0100001100100C00010000CC0100001000111001
110000010100000010C00011110C01000111C01100110000110C110000100100001000111110000C1000000C011011CCC001
1000011C10000010001100000000101001110000000C000000001C0010110001100000101000001111111000000000CC10C1
1C0C0110C01010100111000010111101010001011000000111000001000110C1000011010100000110111010010010011011
1100001000000011001000C1000110010101000011000000C0000C0000100101011101010011000100011110000C0C00CC01
1001000010010010C01000101100C110CC0C10001000C00C1C001000C10C001000000001C10000C0100C01C000C010100001
11C0000010000100000011C011111011000110010101010111010100001C00000C001000000001100011100000101C100C01
100110CCC101100C11000000C01C00000000C11C1111111001101C11010101C10001C1C01000010001010001001010001001
100010011010C0C10010000011101C0000111C0011110011110101000000000000001000110C000001001010001100000011
111010C01001000100C0CC000000101000CC00C01C00100C100000000000010C000C010C000110001C000001100001001001
101001C101101C10000111010011C01100C001C0C0001110C100000010001011110C10000C000011C1C100010C100C000111
1111111111111111111111111111111111111111111111111111111111111111111111111111111111111111111111111111