111111111111111111111111
1PC000C101011000001C0111
1X01110C11111010000010C1
10010000000000010C11C111
100000101000000100010101
1000000010000111E0101001
10000101100001100101CC01
11001C0CC0110100011C1011
100011C010C0100100010001
111111111111111111111111
