1111111111
1100101101
100C010001
1000000001
10101P10E1
1100010101
1011100111
1001010111
1000C011C1
1111111111
1111111111
1010010011
111000C001
1011101111
1C0P100C01
10110C0011
1C00110001
1001EC0011
10C00C1001
1111111111
