1111111111111111111111111111111111111111111111111111111111111111111111111111111111111111111111111111
11011C00111E10100CC1000000001111C0C110101000CE11011010CE0000001000011E100E01E00000E000001100001000E1
100000000C000001E1100C1CE0000000011000E000E000000E0001C01000E0E1100101001100C1100000100000C100110101
1010010011C0C011101011100100E100E100001000001000001C10100000100000001ECE1110101C0C0110E0C00111100111
1C0E100E001100100000C00E1010CC0011E1101E100000110E011010EC001000111E0000100010E1CC1000C0010011000C11
11E0010100CE1C00E0000E0100C00CE001000000C00001C0100011011CEC1000C0C10011C01C000010C0C0C100101E01E001
1CC100E0110110011100C1C00E0E1000111C000000E110C011101EE111100001001010001101E000000E01EE1E10001C0E11
10E100110C0C1E100000001C001011101E00011001CE11100EE0100100110001C0C11100C1C11E1E0001EE0001011CE01E01
10000C01E00101110001001E1110E11C101101000101C11E10E000C1000E10E1001C11C0E101E00000000CCEC100C1000EE1
100101000EC0E00000CE01C000100010010011111010000E01000E1C0E011E0110CC1000110C0100110100E0E011E0E0C001
1C01011CC0C000C01001C0000C01111101001011010C0001E101C110C1E0E11010110011C0C0C0E010100101000C001E1E01
1000000CECC1001000E1000E10000C0CE00CC11000E101E0C0C100000101000100C0C10E011C011100100E001CC00CE11001
101100000100E1E0001001E00100CE01100011C00100000E01000E101CE0C010101000110CE000100C001000C00001001001
110C01CCE0101E0E111E01100E01011101100000101000C01001111E010000100C0001010001E010EE1C010C0010010E1C01
101E1000010E0000CC00E01000000110C0011E0C1000E110C000C0001000E0111101EC0E111101101010EC00100C0100E101
10EC1000EE010000C110010E000001E00110110000E011E0100000110100001001C000E00101010C1C010C0E111001000001
11001EEE0001000C00010000101E1001010C0C000E000100EE00000101100E100E00C001E0ECE001C011100C1000C0000001
1E11EE11000C0E11100E001E01110C0000E0E010E000E001001100C0EE011C100000E000E1EE100011001C1001010010C001
1E01CE00000E1E010C0011001110C1101011000000100111EC1111E110010C00C0110010100001C00EC0E0000E0E1110C001
1101C0000EC1C111110E111010110C1101011100C00E1011E010C1111010E010100000100101101001111EC001100C010101
11101C0C010E0EC11000001EC000010010100110000100CE0C0E00E100111101001101100CC0E0E010001000C0C100CC0E11
111C1011101011C0C1C0C01100C01000000C000110E11C0EC111C1CCE11100000000001CC110C01E00100101001001000001
1101C0100CC100011CE00000101E1C1E10101001E0E11E0010C011E110C000111C01C010001CC00001100100E011E101C011
11110C10C001011100E0E100111100010C0C000010E01C11E00010C11001EE01C0100100E0E0E0E00101EC10111100000001
10111E0E10C0101000E0001C000000100000100000011000C00001001CE11101C0010CE110E0C01011E1E00CC000EC10CC11
10C1E01CE1C10100E100100010101001000001C0010000111C1E1EE0110C0E100E1101000001CEC0E100C1010E11C0001101
1000110011011100000111111E00010C11100101111E11E00000E010100C111010100100000E11E000E0E1CC100010000E01
100000C00C0000EE1C01001110C00E0E1C0CC00E010C1100C000010000011010CE00001000010E1E0E1000001CEEECE000C1
1100C10E00010000000100001C1C0001001100101CC000010010101100000C10011010000C0010C0100100C0000C010CE1C1
11001CC010E10CE1010011C11C1C1E100E0100E1110010000C11001C01CCC0E00110CCE011100C0011EECC010E0010011011
101000110000010E00000001C10100E00001000000000E1C11100101E10101E01010E00E0010C100100001001E0110000001
100C0E10100110010001EC1000111100E100101C1E0000C1101000C0111011C10000011C111E0E00E10100C01ECC01C001C1
10110001E1C000010E0110C1110011000011010E00CECEE11010000000000E00C10100010C000001E01C00010C00E0E00101
101001010E111E101010C01111000011101000C10C0011CE11111001100C1C00EE1101000C100111101101C0EC001E001001
1100010111010010010001100100000E10C0E0101100010111C0000001101101C0101C000011110110CCE10001000EEEC001
1E001C10111E010000E11000E00E1011E00100CC10001ECE00EC01C1101101CC00000C1000E00000E010000001C1E10101E1
1E0C0000E10011EC00001C00000E10E1010011E00101010111E000011C0E001011100111C101E001001000000E1011111101
11CE001E0C001110C10000C00010C00110000100110C00000101111000E00EE0010C10EC00111E0E000100C00100C00110E1
1C101001E001100011101C100C0C011111CCC0E10000000E00C000E0100001010100C0CC0000PC0010C00E0C001001E00001
1EC011EE0EC01E10000E0C00E000100011001111101CCC01001001E0C1110000110100000011000E00E0100001C010001C01
111C0C10E000EE010C1001010101E1EC01E00100110CE1001100E000C11001100E000000E001C11110001E111CC101EC0011
1C10101010101E01E0001000011E01111C00C110EE11110C11100010E0C10001C0CCCEC0010E00001C011011010000001C11
10C0E1E1010001E0000111E0CE100000C0011C011C100100000C00C0E00E101100C010E0110000E111E00E010CE010E110E1
101010C101EE001C0000001E0001C010E0E01110000000001100C100011000E00110C011C0C101E11001001E1E00C1100E11
110001000001EC0010E10E11C010001010100100010E0C0010EE0001110C00001E0100EEC010EEE010010100CE110C000E01
1101010010E11C0E001E001101EE011CC000C001C10EE00CCEEE01C1000110C0110E000E00011C1100CC000101110E111111
101001011100000E0111E11011C0000C110EE0000EE1C100110110C0101E00C01E1001110E000C0C1C01E10101C10001C0E1
1001001000ECE11010E1E10100C001C1CEC1EEC0100101C00ECEE10C01CC00101C0E0101101100010E0000100E0100101111
1C11C10C011110CE00110E1C00101000C1010010100001000E01101000110CE010111C010C01C10E0E0C001CE10000000001
1111111111111111111111111111111111111111111111111111111111111111111111111111111111111111111111111111