1111111111
1011001E01
1110C0C101
10000P1101
1111111111
