1111111111
10000C0101
10000P1CC1
1000C11011
100110E001
1C11000C11
1C10110101
1000010011
100C10CC11
1111111111
