11111
10001
10001
1P1E1
1111C
