1111111111
1010000001
11000P11C1
1000001C11
1C11010101
11C01CC101
1001010011
1111000001
1000E11001
1111111111
