1111111111
1000101011
100010C001
10C0000001
10010010C1
11E1000011
1C00P01111
11C0001011
1000000101
1111111111
