0111111111111111111111111111111111111111111111111111111111111111111111111111111111111111111111111111
1000000100C00100C11C0100000000010100001000C01011001010101011110000010001C100100101001C101011C0010011
1000000100C0010110C1010011000100010000001000C110C010000000101001001000010000010C00000011100101C01001
10C0000000100111100001011001000C1010001C1000000100101010000010011000010001000000001001C10001C01100C1
1C10010000000101111C0C00C011C0100100011001011C00001000C11C111100CC0C00C1011000100100110111C100011101
1000010111010101011111C0000111000010C0111CC00000000000010100000100C0000C0010000010000C10C00C00000011
1000001000110C000101110C0100100010000001001000010000010C000C0100000CC00C0101110011000C00001000001C11
110011010101C010111011C1C001000111010010C0000C1111C000C010001010000111001110C000001100C1001011010111
101010011101100C1101000110111100C0C0000000000101CC010110111010110100000C01C00010001000C0101C01100001
1101110001C01001100C10C0010011011010001010010000000110110010100C10001010C1111010C0100010000110110111
1010001C10C0101010101C01C110001110100000000C000110CC00001C00000C00010C001000000000100011010001100001
100101C001110110001001101001110C0100010C0C000C100001000C0000011010000111C0010000C01010C0000001100011
110C0010010001100000C101010001101011000000000000000000C0C0010100000C101101C1C1C010010001010000000101
1100001001000011001001000100C0000000010110100C0000100101C0001110000C10001000100C01000C011CC0011C1C01
11101C00C10C110101011C0100010000C0C0001001100C100110100C100000000001001CC011100100001001001000011001
100000C00010100000C010011000000000C01C101000000C01000000011100000100000C001110100C011000000C00010101
10110C10110111C00C101C00C011001100C010101100010C000010C0010101100010C00000101000001C01CC010000100111
11000010C01C00111001010010C100000100010000110100C10001C11C01CC0101001101000011111011101010001C11C001
101000001010100C100110000011000011010010000000C001010001001100001CC11C100000000110010000001101C01001
10000000C000010010001010000010010000100C00111010C00C01C0E1100010110001000110010000000000C11010100001
110000100C0C00111C001001111011001000100C00100001010C01000110110C0100C0010C1010111000C111011100100011
11C00110100000110100C00010C01110000010110C00000000011C0011000000C10C1010110C0C100010110000010110C011
10C0110100C0C010000C1C10000100100C01000101101C1C01110001000011C0100C00110001C01001110000100C100000C1
101001C001000C10011001111000010110C0CC1100010000C00000010C110110C00100C0100C001001C1C000101C10100001
11C11100001C10010C1C0000110110101000010C0CCC0001000C0C0000C110C1C0011101111101C1001111C1010110100011
111010C000000000110C0000010001101P011010C000C001C000C000111000CC1111000010000CC001010001101C000010C1
1000C00011010001000000010011000001C10100001C010010101000C00100C00001000101101011C000000011C000000111
1000C101C01000C10C00000001001C011010101000100011000111C01100110100100000C1C010100101000C0C0001000101
100011C10C0000000C10101000000000001100111100CC0C110000C01110101100010100100C00000000000111C000011001
10C1CC00111001001110110001E0001010011C01000011C0000000010000011C000C0000010C0010C00001000000101C0001
10000000000100110C001001100100100010C1110111001C1C0C001100010C011C010C011C000C010CC00010000101010001
11001010001010000010100000010CC000000000010110C111010000C1C0C01000000C100000000100100000010001C01001
10100010000C000000100000000100C10C11C00001000100101010100011000010000010011110101010C010C00101C00101
101100010100100100000C10C10100001010001011010000000001C110001010CC00C01C010111111011000C0C0C10011011
1000001000000110C01C101000100C000C0000CC0C110100001001000011C0000C10C1110000C100C00000CC000100100001
1001110CC0C0101CC010C0C01C1001011111100000000101001000100CC01C00000C0000010000111001001CC000C11001C1
1100C0011011C01000100101011101110001000011110100011C00101C10C000C00001000C110C01000001010C1CCC010111
1110000000C1101110100000000001C0C000000C0000100C00110101000C0000000101010000000101C00000001000C000C1
10C10000110C0000000100111010C11C0110100100000101010001C0000100011C10010011C1101010010010000C0100C001
110001101000100110100010C01110000100010CC001011010001110C001C01101001111010C101100001111010000110101
110100011C000000111100110000C00101CCC1000101001C0C001000010010C0100C10001000010010100110010000C01001
10000000000CC100C00100001000010010C00001000C0010C1101C11001011C100C000110C0001101001111100000100C101
1C000101101C001011C100000C1000110000C010000000000010010111C1000010010000100010100001010C1C10C1000011
100000011110C0000001100000C00000000010000110001C0100CC0010100000000001001000001C000001001001C1C0C001
10000101C0011010010100C00100000C1C0000C0001010C0010001C0C0001000110000000C1011CC10111C01100010011001
1010011100C10000C000CC0101010C0000110000100010C00001000C001101C010000C001110000010C0101001CC10100011
1C111000000C1100101C10011010010001010010001011010100C0010000100000100011000100000000000001101100C011
1110001C00000C1010010CC001000C00C10000011CC0C001C010C00C0001001011001010001011100C0110001100C0000001
1000010CCC001C01100100010001000001C0000010010010001C10000C0001011010C000C0101C10110101001010CC000001
1111111111111111111111111111111111111111111111111111111111111111111111111111111111111111111111111111
